XOXXXXXX
XOXXXXXX
XOOOOXXX
XXXXOXXX
XXXXOOXX
XXXXXOXX
XXXXXOOO
XXXXXXXO
